# Gboard Dictionary version:1
magisk	Magisk	
aex	AEX	
alexkillers	alexkillers	
aod	AOD	
apt	apt	
bilibili	bilibili	
bin	bin456789	
bmap	Bmap	
bug	Bug小王子	
centos	CentOS	
chromeos	ChromeOS	
clashr	ClashR	
coolapk	CoolAPK	
crdroid	crDroid	
deepin	Deepin	
devcheck	DevCheck	
dir	Dir	
edge	Edge	
edxposed	EdXposed	
evolutionx	EvolutionX	
faceunlock	FaceUnlock	
fairyex	fairyex	
flyme	Flyme	
fotor	Fotor	
fydeos	FydeOS	
gapps	GApps	
gboard	Gboard	
gcam	GCam	
greenify	Greenify	
h2os	H₂OS	
hackintool	Hackintool	
hackintosh	Hackintosh	
havocos	HavocOS	
huawei	Huawei	
ikirby	iKirby	
ios	iOS	
ipad	iPad	
iphone	iPhone	
itranslate	iTranslate	
itunes	iTunes	
iwatch	iWatch	
lawnchair	Lawnchair	
mac	Mac	
maciasl	MaciASL	
macintosh	Macintosh	
macos	macOS	
magisk	Magisk	
martincz	Martincz	
mback	mBack	
mindly	Mindly	
miui	MIUI	
mokee	Mokee	
mokee	Mokee	
netease	NetEase	
nevo	Nevo	
nevo	Nevo	
nevolution	Nevolution	
nevolution	Nevolution	
nzjjimmy	NZJJimmy	
oasisfeng	OasisFeng	
onedrive	OneDrive	
onenote	OneNote	
oneplus	OnePlus	
open gapps	Open Gapps	
oxygenos	OxygenOS	
pandaria	Pandaria	
pe	PE	
phoenixos	PhoenixOS	
photomath	Photomath	
pixelexperience	PixelExperience	
pure	Pure轻雨	
remixos	RemixOS	
scene	Scene	
shadowsocks	Shadowsocks	
shadowsocksr	ShadowsocksR	
ss	SS	
ssr	SSR	
sky	Sky光·遇	
smilesoft	SmileSoft	
substratum	Substratum	
sudo	sudo	
taichi	TaiChi	
telegram	Telegram	
thanox	Thanox	
tim	TIM	
tragedypz	TragedyPZ	
ubuntu	Ubuntu	
v2er	V2er	
v2ex	V2EX	
v2ray	V2Ray	
viper	VIPER4Android	
viper4android	VIPER4Android	
vmware	VMware	
wechat	WeChat	
weishu	weishu	
wenjiahong	wenjiahong	
wepe	WEPE	
xhifi	XHIFI	
xiaomi	Xiaomi	
xmind	XMind	
xposed	Xposed	
yc	yc9559	
z	z919126592	
zarchiver	ZArchiver	
zorinos	ZorinOS	
zzmind	zzmind	

